archipelago	群岛
aviary	鸟舍
anesthetic	麻醉药
allegory	寓言
appraise	估价
alcove	凹室
assumption	假定，设想；采取
ape	模仿
aseptic	抗菌的
aesthetic	审美的
amenable	有服从义务的，随时服从的
apiary	蜂房
audacious	大胆的；鲁莽的
ancillary	辅助的
amiss	出差错
atrocity	暴行
alimony	（离婚后的）生活费，抚养费
augury	占卜；预言
annuity	年金，养老金
awry	扭曲的；歪曲的
abate	减弱，减少
amputate	截肢，切除
affluence	富足，财富
apposite	合适的
avow	宣布
addle	搞混
accord	一致
apropos	关于
autocratic	独裁
abnegation	批判，自我牺牲
arrears	欠债
actuarial	保险精算的，精算
asperity	严酷，粗暴
accomplice	共犯，同伙
apocryphal	杜撰的
atavism	反祖；隔代遗传
allure	诱惑，引诱
arcane	秘密；谜
auroral	曙光的，极光的
analgesic	止痛的
astringent	收敛的
anthology	选集
aptitude	能力，才能
anathema	诅咒
annul	废除取消
attenuate	削弱
aristocracy	贵族
archaic	过时的
anemia	贫血
astute	机敏，狡猾
annals	记录，历史
apotheosis	神化，典范
abase	贬低
aberrant	不正常的
ambiguous	模棱两可
acoustics	声学的
accost	搭讪，邂逅
adroit	熟练，有技巧
ambivalence	矛盾的观点或情绪
ascetic	苦行；禁欲
anecdote	奇闻轶事
affinity	亲缘关系
acquire	获取
acetic	酸的
austere	严厉的；朴素的
aphasia	失声
aplomb	沉着，垂直
anoint	神圣化
abortive	不成功的，失败
animated	活跃的，有生气的
adept	擅长于
astral	关于星的
ascribe	归因于；指派
alloy	合金
amalgamate	结合，整合
abduction	绑架
acidulous	酸的；尖锐，刻薄
antecedents	祖先。先例
artless	朴实
abysmal	无底的
acme	顶点
adventitious	偶然
astigmatism	散光
appease	平静，安抚
amenities	令人愉快的，礼貌的
append	追加，附上
arduous	努力的
asylum	庇护所
ashen	灰色
apologist	辩护者
alchemy	炼金术士
adjunct	无用的附加物
abrasive	摩擦的，粗糙的，研磨剂
absolute	坚决
auditory	听觉的
affiliation	联合，加入
asymmetric	不对称
acrophobia	恐高症
aquatic	与水有关系的
atrophy	萎缩，变得没用
antiquated	过时的，陈旧的
advocate	辩护
accrue	增加
accommodate	招待，食宿，适应
asinine	愚蠢
authenticate	鉴别
avid	贪婪
appropriate	获得；挪用，据为己有
abstract	抽象的
atone	补偿；偿还
abominable	讨厌的
askew	歪斜
asunder	分裂，分开
apprenticeship	学徒身份
acerbity	尖酸的（语气，脾气）
agent	方法，工具；代表
arboretum	植物园
anthem	圣歌，赞美诗
abridge	删节，节选
acute	尖锐，敏锐，急性
antithesis	对立面
agglomeration	聚集，累积
adapt	改变
artisan	工匠
assurance	担保，保证；确定；自信
assimilate	吸收；同化
alimentary	营养的
ambience	环境
ardent	激烈的；热心肠的；有激情的
arroyo	干枯的河床
apparatus	器械，设备
adjacent	邻近的，毗邻的
anticlimax	反高潮，突降
agrarian	耕地的，耕种的
adherent	支持者，追随者
askance	瞄，不经意的斜视
ambulatory	可移动的，不固定
affable	平易近人的
abundant	丰富，富足
assuage	减轻（痛苦）；满足（饥渴）；安慰
abeyance	悬而未决
anthropomorphic	人形的
adversity	贫困，不幸
avocation	副业，业余爱好
amiable	可爱的，友好的，惬意的
arid	荒芜的
avuncular	像伯父（叔叔）一样的
apparition	鬼，幽灵
audit	审计
acclaim	赞扬，表扬
articulate	有效的；独特的
addendum	附加，补充
archaeology	考古学
armada	舰队
anthropocentric	人类中心说
aromatic	芬芳的
allocate	分配，制定
abut	毗邻
abbreviate	减短，缩写
abyss	深渊，深坑，无底洞
acquittal	无罪开释
amorphous	无形的，不成形的
agnostic	无神论者
abusive	粗俗的侮辱，对身体有害的
amicable	温和的，友好礼貌的
augment	增长
antidote	解药
abject	穷困潦倒，卑微
acuity	尖锐敏锐
actuate	推动，促使
aggregate	收集，聚集
animus	敌意
accede	同意
authoritarian	独裁
ample	丰富的，富足的
amble	漫步，缓行
alloy	混合，中和
amphibian	两栖的
aphorism	格言，警句，谚语
agility	敏捷
atlas	地图集
azure	天蓝
astronomical	巨大，广阔
adamant	坚定不移
advent	到来，出现
agitate	激怒，打扰
aspirant	有志者；有抱负的人
anonymous	匿名的
analogy	类比，相似
abet	帮助，鼓励
aggrandize	增加，加强
avert	转移；防止
abstain	戒酒弃权
affront	冒犯侮辱
analogous	类似的
aghast	吓坏了的
avenge	复仇
allude	暗指
appall	使惊慌，震惊
auspicious	幸运的，吉祥的
artifice	技巧；欺骗
anthropologist	人类学家
addiction	瘾，依赖
adverse	讨厌，敌意
ambidextrous	双手都灵巧
assail	攻击
adhere	黏着
anthropoid	类人的
anachronistic	时代错误
arbitrary	反复无常；残暴；随机的
accoutre	装备
angular	有角的固执的
address	发表（演讲），处理，讨论
acclivity	上山的陡坡
aerie	猛禽的窝
abhor	憎恨
apprehend	逮捕；惧怕；领会
assent	同意；接受
awe	敬畏
abdicate	放弃
aria	清唱剧
abrogate	废除
alias	别名
aspersion 中伤
alacrity	欢快的情绪
antipathy	反对，厌恶
atypical	非正常的，不正常
aftermath	后果，结果
arousal	唤醒，激起
annihilate	毁灭，破坏
ancestry	祖先
amnesia	失忆，健忘
adage	格言，谚语
acclimate	适应
aureole	日冕
acrid	尖锐；尖酸
attribute	属性
ascendancy	统治，控制
arable	可耕种的
acknowledge	认可，承认
allay	缓和
affirmation	正面肯定，确认
accentuate	强调，重音
acumen	思想敏锐
annotate	评论，注释
arcade	拱廊
appreciate	感激；增值；赏识
alienate	孤立，树敌
accretion	增长
auxiliary	辅助的
absorb	吸收，合并
atheistic	无神论
arbiter	仲裁者
amphitheater	椭圆形的剧院，斗兽场
ameliorate	提高
affected	假的，做作的
abolish	废除
antiseptic	抗菌物
abrade	磨损，侵蚀
anarchy	无政府主义
alleviate	解脱，释放，释然
apocalyptic	启示的，启示录的
antediluvian	远古，上古，及其久远
axiom	公理，自明的道理
aloof	分离，保留
anomalous	不正常的，变态的
advocacy	支持，辩护
antecede	先于
abstinence	节制（饮食）
anonymity	匿名
avarice	贪婪，贪财
attain	获得；完成
aggressor	攻击者
apprise	通知inform
amplify	放大
accessory	附件
attentive	专心的，专注的；全神贯注
assay	分析；化验
academic	学术的
application	勤奋的付出
assert	断言
abstruse	难以理解的，复杂的
attest	证明
abash	使难堪
arraign	传讯；责问
amnesty	赦免
assiduous	勤奋
amass	收集
apprehension	害怕
anomaly	不正常
averse	反对的
artifact	人造物品
acrimonious	挖苦的，尖酸的（语言，行为）
apathy	冷漠
approbation	同意，批准
affidavit	宣誓书
archetype	原形
abstemious	节制（饮食），调节
assessment	评价，评估；判断
autonomous	自治
amity	友谊
aversion	厌恶，抵制
altercation	大声争吵，激烈争论
automaton	机器人
arsenal	军火库
array	排列，装饰
apolitical	不问政治的
absolve	赦免
alliteration	头韵
abjure	发誓放弃
anguish	极度痛苦
ascertain	确认，确证
apogee	顶点
allusion	暗指，暗示
avalanche	雪崩
annex	附加，并吞
affix	增加，附于
arbitrator	仲裁者
authoritative	权威；独裁
animosity	仇恨
accolade	出名的大奖
adulation	奉承，恭维
appellation	名字，标题
altruistic	无私的，关心他人的
august	威严的；令人印象深刻的
asteroid	小行星
aperture	洞，穴，孔
apostate	变节者，脱党者，叛徒
amend	修订，修改，变更
anchor	固定；锚
attrition	裁员；磨损
admonition	警告
aspire	热望；热心于
allege	断言
abscond	隐匿，逃避，躲债
aloft	向上
autopsy	验尸
ablution	洗
aquiline	弯曲的，钩状的
allegiance	忠诚
amoral	不道德的
anarchist	无政府主义者
accelerate	加速
acquiesce	默许
aboriginal	原来的，土著的
adversary	对手
affliction	痛苦
agenda	议程
accessible	可得到的
arrest	阻止；引起注意；吸引
amulet	护身符
admonish	警告，训斥
amorous	爱情的
adulterate	掺杂
archives	档案；档案馆
apex	高点，顶点，高潮
adorn	装饰
aver	断言
antagonism	反抗，敌对
bristling	竖立的
bedraggle	邋遢的；湿的
quorum	法定人数
bereavement	丧亲
quiver	颤抖；箭筒
bombardment	轰击（导弹）
bogus	赝品
bevy	一群（少女，小鸟）
barb	鱼钩，钩状物
balmy	柔和的；芳香的
beam	光束；铁梁，木梁；一束电波
bemoan	哀叹，悲伤
bellicose	好斗的，好战的
balm	（止痛的）安慰物
bawdy	猥亵的；下流的；卖淫的
buffet	殴打，斗殴
bauble	小玩意儿
blighted	毁灭的
beseech	乞求，恳求
bloated	浮肿
blandishment	阿谀奉承
bantering	开玩笑的
quagmire	沼泽；湿地
bolt	螺栓；逃窜；狼吞虎咽
bludgeon	大头狼牙棒
badger	激怒，纠缠
bequeath	遗赠，（代代）相传
bovine	牛的；迟钝的；耐心的
berserk	疯狂的，狂暴的
bleak	暗淡；凄凉
brusque	唐图；直率；粗暴无礼
bilious	恶心；暴躁
bilk	骗
bent	先天的
bureaucracy	官僚机构
barrage	弹幕，火力网
brunt	冲击
bohemian	不合习俗；放荡不羁
blurt	脱口而出
queasy	恶心的
besmirch	弄脏，玷污
quadruped	四足动物
qualms	不安；良心责备
bode	预兆
bucolic	田园的
bullion	金条，银条
bourgeois	中产阶级；平庸的
bestial	残忍的
beatific	祝福；幸福的
braggart	自夸，吹嘘
bivouac	帐篷
bandy	争吵，乱传
beatitude	祝福
bombastic	夸张的
browse	吃草；浏览
bolster	支持，增援
blanch	漂白
banal	平凡，陈腐，老生常谈
bacchanalian	喝醉的，耍酒疯
boon	恩惠，福利
bland	温和的
bate	压制
baleful	恶意的，有害的
bane	祸根
bountiful	富足的；慷慨的
boundless	无限的
belated	推迟的，延期的
querulous	鸣不平的；易发牢骚的
quiescent	沉寂
boorish	粗鲁；笨拙
billowing	波涛翻滚
belligerent	好斗的，好斗嘴的
bustle	忙碌
biased	偏见的，偏差
betoken	预示；表示
buttress	支持
bulwark	壁垒
bedizen	俗丽，俗气
blasé	厌于享乐
baroque	华丽的
badinage	开玩笑，揶揄；取消
bigotry	固执
quixotic	空想的；狂想的
beeline	直线
brevity	简短，短暂
biennial	两年一度
babble	嘟囔
betray	出卖；背叛
belittle	蔑视，使渺小
bravado	虚张声势
beguile	欺骗；消磨时间
bumptious	自以为是
balk	阻挠；畏缩
bask	享受（温暖）；愉快，舒适
brandish	挥舞
benefactor	恩人，赞助人
burlesque	作秀，滑稽
blasphemy	亵渎
befuddle	迷惑
buccaneer	海盗
quaff	一饮而尽
quietude	平静；宁静
blunder	错误
quip	嘲弄；讽刺
bestow	给予
barterer	交易商
barricade	屏障；障碍物
bard	（吟游）诗人
qualified	有资格的；有限制的；被限制的
blare	大声喊叫，令人眩晕的强光
brawn	强壮的肌肉
ballast	配重；沙袋
begrudge	愤恨；嫉妒
blithe	欢乐，高兴
browbeat	吓唬
booming	快速增长的，欣欣向荣；深刻的
bicameral	两院制的（参，众）
query	问询；质问
baffle	挫败
besiege	围攻
broach	介绍，提出，引见
barren	荒芜的，贫瘠的
bungle	搞砸
bicker	争吵
quack	骗子；吹嘘的人
brazen	肆无忌惮
quail	懦弱；胆怯
benediction	祝福
quell	扑灭；镇压；平息
quench	弄湿；扑灭；熄灭；淬火
quaint	古怪；古雅
quirk	怪癖；twist
bemused	困惑的，发呆的
beneficiary	（遗产）受益人
beneficial	有用的
bluster	咆哮；吓唬
behemoth	怪物；怪兽
bizarre	怪异的
burly	魁伟，结实
breach	违约；突破；打破
beleaguer	攻击；使烦恼
quay	码头
bait	欺负，玩弄，折磨
bereft	失去的，缺少的
buoyant	可漂浮的，乐观的
bluff	直率；吓唬；悬崖
bungalow	小平房
beset	困扰
brindled	有条纹或斑点的
buxom	丰满；充满活力；欢快
boisterous	吵闹难管束
brooch	胸针
berate	严厉指责，谴责
buffoonery	滑稽的
belie	掩饰，造成假象；矛盾
blatant	喧闹；俗丽
quandary	两难的困境
bowdlerize	删除
bastion	堡垒；工事
breadth	宽度
quizzical	嘲弄的
burgeon	发芽，成长
beget	得子；产生
quarry	采石场，开采；猎物
quintessence	精粹；精华
benign	良性的，好的；和蔼可亲的
quarantine	隔离
brittle	易碎的；困难的
quibble	吹毛求疵
belabor	嘴贫，过度的说；谩骂
benevolent	慈善的
burnish	擦拭
brochure	小册子
betroth	订婚
exonerate	免罪
ejaculation	迸出；惊叹
exploit	开采利用；功绩
expedite	加速，催促
earthy	粗糙的；未加工的
efface	抹掉
exhort	劝诫，忠告
exceptionable	引起反感的
entomology	昆虫学
evasive	逃避的
extant	现存的
equestrian	骑马的
enfranchise	赋予公民权（投票权）,解放
expansive	扩张的；爽快的；广阔的
episodic	插曲式的
enunciate	阐明，清洗发音
equine	似马的
eclipse	超越；衰落；失色
exegesis	解释，注解，通译
enhance	增加；改进
effrontery	厚颜无耻
eccentric	古怪的，奇怪的
embroider	镶边，绣花；添油加醋
entice	引诱，怂恿
exhume	出土，发掘
enrapture	着迷 狂喜
eloquence	雄辩；修辞
engender	产生，导致
empirical	经验主义
efficacy	功效
entitlement	权利
epoch	时代
enigmatic	朦胧的；谜一样的
erotic	情欲的
exuberance	富得流油的；精力充沛；浪费，过度
elegy	挽歌，悲歌
extol	赞美
entity	实体
expertise	专业知识，技能
effete	软弱
extrovert	性格外向的人
exotic	陌生的，外来的，奇异的，异国情调
energize	鼓舞
erudite	博学的
engaging	有魅力的，有吸引力的
euphemism	委婉的表达
exult	高兴，兴高采烈
expunge	删去
edict	法令，号令；布告
endemic	地方的；小范围内流行
empathy	移情作用，心入
elaboration	细节；复杂
exertion	努力，尽力
embark	着手，登船
extort	敲诈，勒索
equanimity	镇定
exculpate	开脱，洗脱
ephemeral	朝生暮死，短暂，短命
entourage	随从，随行人员
encumber	拖累，负担
exemplify	作为典型；具体化
estranged	分离的；孤立的
eccentricity	怪僻，古怪；特性
excise	去除
emanate	散发，发出
embrace	拥抱；接受，包含
eon	时代
evanescent	消散的；凋零的
extrude	挤压，逼
enterprising	有魄力
execute	执行，完成
enmity	憎恨；仇恨
evocative	唤起的
emulate	仿效；抗衡
expletive	脏话
eddy	漩涡
epicure	老饕；享乐主义者
enduring	持久的；不朽的
expenditure	支出，花费
embroil	连累，牵连；使其混乱，麻烦缠身
exposure	曝光，揭露；暴露（于疾病、恶劣的环境等）的状态
equivocate	含糊其辞
expropriate	没收，剥夺，征用
execrable	可恶的，讨厌的
emendation	改进；修订
equilibrium	平衡
erroneous	错误
equable	平和温和
expiate	赎罪
enthrall	迷住
ethos	社会精神特质，思潮，风气；气质
embellish	装饰
emancipate	释放，解放
elated	过分高兴的；兴高采烈
exacerbate	恶化，加剧
egotistical	极度自我中心；自以为是，逞能
epithet	绰号
exalt	晋升；赞扬
excoriate	痛斥
ethnic	种族的
endearment	爱慕；爱的表示
exacting	苛刻的
enamored	迷恋
endorse	认可，默许；支持
embargo	禁运
exempt	被免除的
elucidate	解释；启迪
equitable	公平的，公允的
enclave	飞地
extradition	引渡
enormity	巨大的，严重的，极恶劣
encroachment	侵蚀；“和平演变”
esteem	尊重；估价
ellipsis	省略
etymology	语源学
exorbitant	过度的
entreat	恳求
epilogue	尾声；收场白
expository	解释性的
enumerate	枚举
emollient	缓和，安抚
espouse	支持拥护
equivocal	蓄意误导；含混，模棱两可
explicate	解释，澄清
entail	使……必要；继承
ennui	厌倦
ecclesiastic	神职的
expedient 权宜的，有利的
exasperate	激怒
epitome	典型，摘要
eerie	怪异的，可怕的
extent	范围；程度
enigma	谜
embezzlement	贪污
encompass	包围
epistolary	书信的
engage	吸引；雇佣；答应；结合；订婚
egress	出口
exemplary	典范的
epitaph	墓志铭，挽联
effectual	有效的
edify	教导；启迪，陶冶
euphonious	悦耳的
extraneous	无关的，不重要的
engross	全神贯注
epigram	警句
elicit	引出
elixir	包治百病，万能药
egoism	自我中心，利己主义
ensconce	安顿
espionage	间谍行为
exorcise	驱魔
escapism	逃避现实，纸醉金迷
epic	史诗；剧作
ecstasy	狂喜
elliptical	椭圆的
effervescence	泡腾，沸腾；兴奋，活泼
ensemble	全体；歌舞团；套装
extricate	解脱，放出，释放
exploit	开发，开拓
exigency	紧急情况
exhaustive	彻底的，完全的
esoteric	难以理解的，深奥的
effigy	雕像
ethereal	超凡，轻飘
embody	具体化；包含，收录
eulogy	颂词；赞美词
escapade	越轨行为
explicit	清晰的；坦率的
extrapolation	推测，推断
embed	封装，嵌入，插入
effusive	热情洋溢
embryonic	胚胎的；未开发的，原始的
enervate	使变弱
encomium	赞美之词
extrinsic	外围的，不重要的；外来的
egregious	及其令人痛恨的，声名狼藉；令人吃惊的
equity	公平，公正
excerpt	摘抄，摘录
eschew	避
ebullient	热情的，激动的
erratic	古怪的 不稳定的
exude	渗出流出
eclectic	折衷 博采众长
emissary	代理；信使，使者
entrepreneur	商人，企业家，承包人
exhilarating	爽快的，使人愉快的
erode	侵蚀
ebb	衰退
emaciated	消瘦
extenuate	弱化；减轻
evenhanded	公平的
expatriate	放逐；被放逐者，移民
entrance	使其着迷；使其神志恍惚
elusive	难懂的，难捉摸的；令人困惑的
exodus	离开，启程
equinox	昼夜平分点，春分，秋分
encipher	编码
expurgate	清除，净化
exclaim	呼喊，大叫
evince	表明
fabricate	制造；编造（谎言）
facade	正面的；表面的
facet	（宝石的）琢面；方面
facetious	开玩笑 滑稽
facile	容易肤浅的
facilitate	促进；帮助；使变容易
facsimile	副本，传真
faction	派别；内讧；纠纷
faculty	才能，教职员工
fallacious	假的；误导的
fallible	容易犯错的
fallow	休耕地；潜伏的；不活跃的
falter	犹豫；踌躇
fanaticism	狂热的，盲目的
fancy	爱好；奇特；想象
fanfare	号角声
farce	闹剧；嘲笑
fastidious	苛求
fatalism	宿命论
fathom	理解
fatuous	蠢
fauna	动物志
fawning	奉承
faze	使惊慌失措
feasible	可行的
fecundity	肥沃；创造力
feign	假装；捏造
feint	佯攻
felicitous	恰当的
felicity	幸福；恰当
fell	凶猛的，放倒
felon	重罪犯
feral	野生的，未驯服的
ferment	暴乱
ferret	搜出
fervent	炙热的
fervid	炙热的
fervor	热情；激情
fester	溃烂；激怒
festive	节日的
fetid	恶臭的
fetter	束缚
fiasco	彻底失败
fickle	浮躁的，易变的
fictitious	虚构
fidelity	忠诚
figment	虚构的事务
figurative	比喻
figurine	小雕像
filament	细丝
filch	偷
filial	子女的
filibuster	（发表长篇演讲来）阻挠法案通过
finale	结论，结尾，结局
finesse	精密的技巧
finicky	苛求，挑剔
firebrand	煽动叛乱者
fissure	裂缝；分歧
fitful	断断续续；间歇
flabbergasted	吃惊
flaccid	软弱的；无力的
flag	衰弱
flagrant	非常坏的；残忍的；恶名昭著的
flair	才能
flamboyant	华丽的
flaunt	招摇；炫耀
fleck	使起斑点
fledgling	无经验的
fleece	诈骗
flick	轻弹；轻打
flinch	畏首畏尾，退缩；犹豫
flippant	轻浮无礼
flit	掠过
floe	大浮冰
flora	植物志
florid	华丽的；红润的
flounder	挣扎
flourish	繁荣；挥舞
flout	轻视愚弄
fluctuate	波动的；起伏的，摇摆不定的
fluency	（语言）流利
fluke	偶然，侥幸
fluster	慌张
flux	变迁；流动
fodder	粗饲料；饲养
foible	缺点；弱点
foil	烘托；衬托
foliage	树叶
foment	鼓动，煽动
foolhardy	愚勇的；傻大胆儿
fop	花花公子；过分注意衣着的男人
forbearance	耐心
forebears	前人；祖先
foreboding	不详的预感
forensic	法院的；适于法庭的
foreshadow	预言；预测
foresight  预测
forestall	预先阻止
forgo	放弃
forlorn	孤苦凄凉的
formality	仪式；礼节
formidable	令人生畏的
forsake	放弃
forswear	放弃
forte	特长
forthright	坦率的；豪爽的
fortitude	刚毅
fortuitous	偶然的
forum	论坛
foster	养育，培养；鼓励
founder	完全失败；沉默
fracas	争吵；混战
fractious	易怒的
frail 虚弱的
franchise	公民权；营业执照
frantic	狂乱
fraternize 结交
fraudulent	欺骗的
fraught	满的
fray	打斗
frenetic	发狂的
frenzied	狂乱的
fresco	壁画
fret	烦恼
friction	摩擦
frigid	严寒
frivolous	轻率的
frolicsome	闹着玩；嬉戏的
frond	棕榈叶；蕨叶
frugality	节俭
fruition	享用；成就；实现
frustrate	阻碍；挫败
fugitive	短暂的，逃亡的
fulcrum	（杠杆的）支点
fulsome	过分的
fundamental	基本的，基础的
furlough	休假
furor	狂热
furtive	鬼祟的
fusion	融合
futile	没出息；无望，没效果的
gadfly	牛蝇；招人烦的人
gaffe	失态
gainsay	否认，拒绝
gait	步态，步法；速度
galaxy	星系；一群显赫的人；一系列重要的人或物
gale	大风；情感爆发
gall	胆汁，恼怒
galleon	大帆船
galvanize	电镀；刺激，激励
gambit	弃子抢先
gambol	欢跳，雀跃
gamely	勇敢的，有精神的
gamut	整个领域
gape	目瞪口呆
garbled	混淆
gargantuan	巨大的
garish	俗气；颜色太杂
garner	收集，储存
garnish	装饰
garrulous	贫嘴
gauche	笨拙粗鲁
gaudy	俗
gaunt	憔悴
gavel	棒槌
gawk	呆呆看
genealogy	家谱
generality	一般性
generate	产生；创造
generic	普通的
genesis	发源，源头
geniality 和蔼
genre	风格（文学、艺术）
genteel	上流的
gentility	有教养
gentry	贵族
germane	密切相关
germinal	未成熟的，幼芽的
germinate	发芽
gesticulation	动作；手势
ghastly	恐怖的
gibberish	胡话；嘟囔
gibe	嘲笑
giddy	眩晕的
gingerly	小心翼翼地
girth	周长
gist	精华
glacial	冰河的，冰川的
glaring	耀眼的
glaze	上釉
glib	油腔滑调
glimmer	闪烁
gloat	幸灾乐祸，洋洋得意
gloss_over	掩盖
glossary	词汇表
glossy	光滑有光泽的
glower	怒视
glut	供应过剩
glutton	暴食者
gnarled	扭曲
gnome	地精；小矮人；土地公公
goad	刺激；煽动
gorge	峡谷，狼吞虎咽
gory	血腥的
gouge	挖，欺诈
gourmand	贪吃鬼
gourmet	美食家
graduated	分级；排序
graft	移植；移植物；嫁接
grandeur	庄严伟大
grandiloquent	夸张，浮夸
grandiose	浮夸的
granulate	粒化
graphic	图像的；图画的
grapple	格斗，摔跤
grate	磨碎；惹恼；发出刺耳声音
gratify	取悦
gratis	免费的
gratuitous	没必要的
gravity	严重性，庄严
gregarious	合群的
grievance	委屈；不平
grill	拷问
grimace	扭曲的脸；做鬼脸
grisly	可怕的
grotesque	怪诞的
grouse	发牢骚
grove	小树林
grovel	匍匐，卑躬屈节
grudging	不情愿；勉强
gruel	稀粥；极度紧张
grueling	紧张的
gruesome	可怕的
gruff	粗哑
guffaw	大笑
guile	狡诈；诡计
guileless	诚实的
guise	外观；装束
gullible	易受骗的
gustatory	味觉的
gusto	热情
gusty	多风的
hackneyed	陈腐
haggard	憔悴
haggle	讨价还价
hallowed	神圣化的
hallucination	幻觉，幻想
halting	犹豫的
hamper	阻碍
haphazard	随机的
harangue	夸大的讲话
harass	骚扰
harbinger	先驱预兆
harbor 港口
hardy	艰苦的；勇敢的
harrowing	痛苦；悲怆
haughtiness	傲慢；不逊
hazardous	危险
hazy	朦胧的；模糊的
headlong	快速，鲁莽
headstrong	硬脖子；任性；不屈
heckler	质问者
hedonist	享乐主义者
heed	留意
heedless	不留意
heinous	邪恶的
herbivorous	吃粮食的（动物）
heresy	少数意见，异端
hermetic	密封的，气密的
hermitage	隐居的居所
heterodox	非主流；异端
heterogeneous	异质
heyday	鼎盛时期
hiatus	间断
hibernal	冬天的
hibernate	冬眠
hierarchy	分级，排序了的
hilarity	狂欢，欢闹
hindrance	障碍物
histrionic	戏剧性的
hoard	储藏
hoary	老掉牙的
hoax	骗
hodgepodge	大杂烩
holster	手枪套
homage	敬意
homogeneous	同质
hone	磨砺
hoodwink	欺骗
horde	一群
horticultural	园艺的
host	很多；主人；宿主
hostility	不友好，敌意
hovel	小屋
hover	盘旋
hue	色调
hulking	庞大笨重
humane	仁慈
humdrum	单调的
humid	潮湿的
humility	谦逊
hurtle	冲
husband	节约
hybrid	混合的，混血的
hydrophobia	恐水症；狂犬病
hyperbole	夸张
hypercritical	苛刻
hypochondriac	无病呻吟；忧郁症
hypocritical	伪善；欺骗
hypothetical	基于假设的，设想的，假想的
nadir	谷底，最低点；天底
naiveté	天真烂漫的，简单的
narcissist	自我陶醉的人；逞能的人
narrative	解说的
nascent	初生的
natty	穿着整齐干净的
nauseate	令人作呕的
nautical	航海的
navigable	可以通航的
nebulous	模糊朦胧
necromancy	黑魔法
nefarious 极坏的，恶毒的
negate	拒绝，否定，取消
negligence	疏忽
negligible	可忽略不计的
nemesis	复仇的人；寻衅者
neologism	新生词
neophyte	新手
nepotism	裙带关系
nettle	恼怒
neutral	中型的；自然的；中庸的，公允的
nicety	细节
nihilist	虚无主义者
nip	夹，捏；剪断；阻止
nirvana	涅磐
nocturnal	夜的
noisome	臭
nomadic	游牧的
nomenclature	术语
nominal	名义上的
nonchalance	冷淡
noncommittal	不表态的；
nondescript	无特征
nonentity	不存在，无足轻重的人
nonplus	使迷惑；使为难；混淆
nostalgia	想家；乡愁
notable	显著的；值得注意的
notoriety	臭名昭著的
novelty	新奇
novice	新手
noxious	有毒有害
nuance	细微差别
nullify	使无效
numismatist	硬币收藏家
nuptial	婚姻的
nurture	养育；教育
nutrient	营养品
oaf	呆子
obdurate	执拗的；顽固的
obese	肥胖的
obfuscate	困惑
obituary	讣告
objective 目标；客观的
obligatory	必须的
oblique	间接的；倾斜的；无诚意的
obliterate	除去
oblivion	遗忘；赦免
oblivious	遗忘的；出神的
obnoxious	讨厌的
obscure	模糊
obsequious	奉承的
obsessive	强迫性的，着迷
obsolete	过时的；无用的
obstinate	倔强
obstreperous	吵闹难管束
obtrude	强加，闯入
obtuse	迟钝，笨
obviate	避免，消除
odious	可恶的
odium	反感憎恶
odorous	有气味的
odyssey	长期的冒险旅行
offensive	攻击的；冒犯的
offhand	随意不加思索
officious	多管闲事的
ogle	抛媚眼；送秋波
olfactory	嗅觉的
oligarchy	寡头政治
ominous	不祥的
omnipotent	无所不能的；全能的
omnipresent	无所不在的
omniscient	无所不知的
omnivorous	无所不吃的；杂食的
onerous	繁重的
onset	开始攻击
onus	责任义务
opalescent	乳白的
opaque	不透明的
opiate	麻醉剂
opportune	合时宜
opportunist	机会主义者
optician	眼镜商
optimist	乐观者
optimum	最佳的
optional	可选的
opulence	富裕
opus	作品
oracular	神谕的
orator	演讲者
ordain	任命，注定
ordeal	严峻的考验
ordinance	法令
ordination	授神职礼
orgy	纵欲纵酒
orient	定位 适应
orientation	定位（在社会上）
ornate	华丽的；过分装饰的
ornithology	鸟类学
orthodox	正统
oscillate	摆动
ossify	石化
ostensible	假装的
ostentatious	炫耀的
ostracize	放逐
oust	驱逐
outlandish	奇异的；偏僻的；前卫的
outmoded	过时的
outskirts	边界；郊区；外围
outspoken	坦率直言的
outstrip	超过
outwit	智取
ovation	欢呼
overbearing	傲慢专横的
overt	明显的；公然的
overwrought	歇斯底里的
repugnant	讨厌的
reciprocal	互相的；mutual
prodigy	神童
patronize	资助；光顾
painstaking	辛勤的
reticence	缄默
prodigal	浪费的
plaintive	哀伤的
protuberance	隆起；突出
remission	赦免；缓和
pungent	刺激的 （气味）
raiment	衣服
rigorous	严格
profane	亵渎
perverse	作对
redoubtable	可怕的
paranoia	妄想狂；偏执狂
proliferation	增长
philanderer	爱调情的人
repast	宴会
podium	指挥台；检阅台，讲台
retrieve	重新得到；找回
precept	准则
pendant	吊坠
retribution	报应
refurbish	renovate
perquisite	津贴，补贴；奖金
restitution	归还；补偿
rendition	诠释
precipitate	突然的；促成，降雨
precipitous	陡峭的；急躁的
proletarian	工人阶级
rally	集结；恢复元气
prowess	威力
pillage	掠夺
precinct	行政区
rout	打败
provincial	省级的；狭隘的
precipice	悬崖
purveyor	承办商
paraphrase	意义改述
recast	重建
pacifist	和平主义者
repertoire	全部节目
potent	有力的
parody	恶搞
palatable	可接受的；美味的
parity	相等相同
promiscuous	淫乱
relegate	降级
ruffian	流氓
politic	明智
ruse	诡计
resolve	决定；解决
pretext	借口；托辞
refractory	倔强的
pique	怒，激怒
porous	多孔的
reiterate	重申；重复
piquant	辛辣开胃
paucity	缺乏
prestige	声望；威信
pied	杂色的；斑驳的
respite	喘息，暂缓
rebuke	谴责
peripheral	外围的，次要的
perpetuate	使不朽
plaudit	赞美
propensity	倾向
reverent	尊敬的；可敬的
pert	唐突无理
perceptive	有洞察力的，警觉的；智慧的
ruminate	沉思
restraint	克制约束
refraction	（光线的）折射
rigid	严格
replenish	补充
receptive	善于接受的
premonition	预兆
riveting	吸引人的
prolong	延长
paradigm	典范；模式
pellucid	透明；清澈；易懂的
preternatural	超自然的
recidivism	惯犯
progeny	后裔
precarious	危险的
remorse	懊悔，自责
predilection	偏爱；偏好
pugilist	拳击手
pithy	精辟的
privation	缺乏
ravenous	饥饿的
retinue	随从
profound	深刻的
picaresque	流浪汉题材的
phobia	恐惧
putrid	腐烂
reputed	号称的
philology	语言学
prattle	唠叨
rhapsodize	狂热地描述
rankle	激怒
palette	调色板
recipient	接受的东西；容器
purse	皱；钱包
propinquity	亲近
reserve	保存
peccadillo	轻罪，小过失
peerless	无可匹敌的
rudimentary	基本的
revelry	狂欢
potable	可饮用的
rote	死记硬背
plasticity	塑性
rejuvenate	返老还童；青春重回
premise	假定，假设；前提
pallid	苍白的
rift	裂缝
parable	寓言
repulsion	排斥
preamble	序言
replete	充足的
raucous	沙哑的
puerile	幼稚的
panacea	包治百病的药，灵丹妙药
posthumous	死后的，遗腹的
palpitate	悸动
reactionary	反动的
pliable	柔韧的；变通适应性强
piecemeal	逐渐的
partial	部分的；偏袒的
proxy	代理
pittance	微薄的薪水
provoke	挑衅
presentiment	预感
pinnacle	顶点
respiration	呼吸；呼吸作用；呼气
rummage	翻找
purported	谣传的
replicate	复制
ruddy	红的；红润的
profusion	丰富；挥霍
panoramic	全景的
rent	租；裂口
palpable	明显的，显而易见
proclivity	倾向
pessimism	悲观主义者
pejorative	贬义的
prosaic	散文的；乏味的
rousing	唤醒的活跃的
purchase	买；紧握
protocol	协议
reminiscence	回忆
precis	摘要
pedantic	学究的，书呆子的
repeal	废除，撤销
perspicacious	有洞察力的
propitiate	劝解
pusillanimous	懦弱的
relinquish	放弃
poseur	装模作样的人
phylum	门；语群
regime	政体
pseudonym	假名；笔名
rustic	乡下的
rostrum	讲台
perfidious	背信弃义的；不忠的
ramble	漫步
psyche	灵魂，心智
propulsive	推进的；有推进力的
prone	倾向于
remonstrance	抗议
relic	遗物
repository	储藏室
retrospective	回顾的
reconnaissance	侦察
realm	领域
profligate	放荡
rectitude	正直
resilient	弹性的
rigor	严格
resplendent	辉煌灿烂
parochial	教区的；狭隘的
predispose	预先安排，使偏向
renovate	革新；刷新；修复
relent	让步
pact	和约；条约
plummet	垂直落下
polarize	极两极分化
renege	否认
pedestrian	行人；平庸
preclude	排除
pandemic	广泛传播的，流行的
plausible	似是的
pitfall	隐患，陷阱
probe	探测
perfunctory	敷衍
pore	毛孔；细读
pulchritude	美丽；标致
recrimination	反责
polemical	好争论的
potential	潜在的
raconteur	健谈者
recuperate	恢复
reprehensible	应该谴责的
repercussion	反弹；影响
practicable	可行的
pan	抨击
prosperity	繁荣；好运
resumption	恢复；重新开始
partiality	偏见
phlegmatic	冷静
paramount	极其重要的
proximity	接近；亲近
perturb	使不安，使忧虑
parched	干的
plumb	垂直；探明
purge	清除
perforate	打孔
pastiche	集锦
rancid	腐臭的
rebuff	拒绝
renegade	背叛
panache	派头
provident	有远见的；节约
recount	叙述
raspy	刺耳的；焦躁的
prevaricate	支吾，搪塞，说谎
poignancy	辛酸
prank	开玩笑
parsimony	小气吝啬
pertinent	相关的
pine	憔悴；思念；渴望；松树
protrude	突出
resigned	听天由命
prostrate	卧倒的，拜倒的，无能为力的
reputable	名誉好的
rehabilitate	恢复；复原
patent	专利；明显
plenitude	充分，富足
pernicious	有害的，恶性的
rant	咆哮
portly	肥胖的；魁梧的
recession	经济衰退
rapacious	贪婪
riddle	打洞
rhetorical	修辞学的；浮夸的
responsiveness	响应
reparable	可修复的
potentate	当权者
recapitulate	概括；总结
resentment	怨恨；愤恨
philanthropist	慈善家
pundit	博学者；梵文学家
ramshackle	摇摇欲坠的
primordial	原始的
portent	预兆
rail	责骂
paleontology	古生物学
rife	普遍的
pragmatic	务实的
reaper	收割者；收割机
revile	辱骂
pandemonium	混乱，骚乱
passive	消极被动
pastoral	田园的；乡下的
reprieve	缓刑
physiological	生理学的
ramp	斜面；斜坡
penury	穷
pulverize	磨碎
retiring	缄默的
persona	角色，表象人格
pariah	贱民；被社会遗弃的人
refrain	克制
repress	压迫；压制；压
rampant	猖獗的
retrench	紧缩
prompt	促使
patina	铜绿；光泽
prim	一本正经
ponderous	笨重
pedagogy	教育学
rotundity	圆形，球状；洪亮的
repudiate	拒绝接受
paragon	模范
propound	提出
preempt	先发制人
prodigious	巨大的
practitioner	从业者
rationalize	合理化
precedent	先例
render	提出
palliate	减轻
problematic	有疑问的
plight	困境
redolent	芬芳
requisite	必须品；必要的
propitious	吉利的；有利的
perpetrate	犯
prevalent	普遍的；流行的
peregrination	旅程；旅行
preposterous	荒谬
ratiocination	推理；推论
restive	不安的
prune	修剪
rancor	仇恨
pristine	原始的
reparation	赔偿
ravel	使混乱
pacify	安抚；平静
permeate	渗透；弥漫
perimeter	周长
pensive	沉思的；忧心忡忡的
pummel	打
rend	撕开
predator	掠食者
parry	避
perennial	终年的；永久的
pall	变乏味
revoke	撤消
placid	平静的
reek	散发（气味）
recluse	隐遁者；
patrician	贵族的
perjury	伪誓；伪证
pragmatist	实用主义者
penitent	悔过的
prolific	多产的；丰富的
resonant	共鸣的
rebuttal	反驳
refute	反驳
revulsion	情感急变；反感
rubble	碎片
pertinacious	执拗
prey	猎物；受害人，牺牲品
propriety	适当
recumbent	靠着的；斜躺的；
proscribe	禁止
reverie	白日梦
progenitor	祖先
reprimand	谴责
predecessor	前辈
pathos	感伤力
reimburse	偿还
patriarch	族长
protean	多变的，变化多端的
pugnacity	好斗
regale	享用
recalcitrant	顽抗的
ribald	下流的
pauper	穷人；贫民
perdition	毁灭
piety	虔诚
promulgate	发布；公布
rave	口出狂言；胡言乱语；极力赞美
ruthless	无情的
percussion	打击
placebo	安慰剂
reconcile	调和
repellent	排斥的
primp	打扮
provocative	煽动的；挑逗的
permeable	可渗透的
protract	延长
ramify	分支；分叉
rationale	理论依据
rabid	疯狂
prologue	序言
prescience	预示能力
relevant	有关的；相对的
pathological	病理学；病态的
paroxysm	一阵
provisional	临时的
pervasive	遍布的，弥散的
potion	剂量
precocious	早熟的
polygamist	多配偶
prototype	原型
platitude	陈词滥调
polyglot	多语言
partisan	党派的
regimen	养身之道
renounce	放弃
reprise	重奏
plutocracy	富豪统治
piebald	花斑的；斑驳的
portend	预兆
residue	残余
personable	有魅力的
revert	恢复
perpetual	永久的
pander	迎合(不良需求)
resolution	坚定；决心；决定
presage	预示
papyrus	纸草；草纸（古代的）
roster	花名册
remiss	疏忽
reprove	谴责
remnant	残余
preen	把自己打扮漂亮；自满
projectile	导弹
ramification	衍生物；分支
propagate	繁殖；宣传
rapport	融洽
presumptuous	自以为是
petrify	石化
retain	保持
retaliation	报仇
premeditate	预谋，预先考虑
paltry	太少
plagiarize	剽窃，抄袭
pious	虔诚的
rejoinder	反驳
parasite	寄生；寄生体
parallelism	平行，类似
relish	品味；享受
partition	分裂开来
raze	摧毁
punctilious	一丝不苟
pivotal	关键的
puny	小
paean	赞歌
retract	撤回
practical	实用有效
precursor	领跑者，先驱
recourse	求助，依靠
retort	反驳
postulate	假定
rapt	着迷的
propellants	推进剂
rhetoric	修辞学
plethora	过剩；过多
petulant	脾气坏的
rig	装配；操作
punitive	惩罚的
predicament	困境,窘境
reproach	指责
prudent	谨慎的
rarefied	稀薄的
rectify	改正
paraphernalia	随身用具，必要但繁琐的手续
penchant	倾向；趣味
pecuniary	钱的，货币的
repel	击退
ratify	批准，认可
regal	皇家的
retroactive	追溯
peremptory	强硬的，专横的
peruse	细读
protégé	门徒
paradox	矛盾
requite	报答；酬谢
pomposity	自命不凡
prurient	好色的
renown	名望
replica	复制
parameter	参数，决定因素
pontifical	教皇的；傲慢武断
promote	提升；促进
predetermine	预先决定
proselytize	变宗
roil	搅浑
prehensile	能抓住的
retrograde	倒退，退化
prevail	盛行；说服
prerogative	特权
placate	安抚
rue	后悔
resurge	复苏
prophetic	预言的
robust	强壮的
rescind	废除，撤销
petty	微小的，不重要的
remedial	治疗的，补救的
precise	精确的
pachyderm	皮厚的动物（如大象）
pretentious	自命不凡
redress	补偿
plumage	鸟类的羽毛
procrastinate	拖延
podiatrist	足病医生
recant	放弃
pantomime	演哑剧
prate	空谈
pathetic	可怜的
remunerative	酬劳的
prognosis	预诊
redundant	冗余的；多余的
rile	激怒
reprobate	恶棍
prude	拘谨的人
pediatrician	儿科专家
remediable	可挽回的
panegyric	赞美
recurrent	复发的
posterity	子孙；后裔
reprisal	报复
pliant	顺从的
proponent	支持者
pigment	色素
philistine	庸人,俗人
reciprocate	回报
prolixity	冗长的；啰嗦的
prod	刺；戳
retentive	保持的；记性好的
prelude	前奏，序曲
slander	诽谤
thematic	主题的；主题相关的
stalwart	强壮可靠
synthesis	合成
solace	安慰
shoddy	廉价劣质
torpor	迟钝麻木
seminary	神学院；学院；发祥地
thwart	阻碍；挫败
trajectory	弹道；轨道
shambles	混乱，狼藉
stratify	分门别类；分类；分层
temporal	暂时的
transcribe	转录
tome	册；卷
tawdry	俗
seclusion	隐居
surveillance	监视
thermal	热的；热学的
spry	活跃
surpass	超越
subterfuge	借口
solitude	独居
turpitude	邪恶，恶劣
summation	合计总结
sectarian	宗派的；狭隘的
simper	傻笑
symbiosis	共生现象
stricture	约束；谴责
strut	swagger；支撑
secession	脱离
snub	冷落怠慢
touchy	敏感；易怒
truculence	粗野
torso	躯干；未完成的
strident	刺耳的，尖锐的
spartan	刚毅的；朴素的；纪律严格的；斯巴达的
scruple	踌躇；犹豫
truncate	截头或截尾
stultify	使徒劳
skimp	节约的使用
slothful	懒的
sleeper	长期不受人注意而一举受人瞩目的人或物
stamina	毅力
surmount	克服
supplant	取代；篡位
sheaf	捆；扎（秸秆）
salvage	营救
sentinel	看守，哨兵
sect	宗派
tribute	贡品；称赞
stigmatize	打烙印；污蔑
Simplistic	过分单纯化的
sheathe	插入鞘
sententious	简洁的；警句式的
terminology	术语
trough	槽，波谷
subjugate	征服
transcendent	卓越的
topography	地质地形
seasoned	老练的
subversive	颠覆性的；破坏性的
tangential	外围的；离题的
tensile	可伸展的
salvo	齐射
swarm	一大群；蜂拥
stodgy	古板
sequester	隐退；隔离
sophomoric	一知半解的；二年级生
skulk	躲藏；偷偷的移动
throng	聚集
sustenance	支持物；养料
stilted	做作的
stratum	地层；社会阶层
shroud	裹尸；隐藏
slovenly	懒散邋遢
spurious	伪造的
tightwad	吝啬鬼
stupor	恍惚；昏迷
savor	享受enjoy；滋味
sheer	完全的；垂直的；透明的
salubrious	对健康有益的，利于养生的
stanza	（诗）节
scale	攀登，衡量
tyranny	暴政；专制
stalemate	僵局
traverse	穿过
steadfast	坚贞不渝
sonorous	洪亮
torrid	炙热的
seethe	沸腾
tactile	触觉的
sumptuous	奢侈的
tenet	原则；信条
tentative	实验性的
tantrum	发脾气；暴怒
sinuous	蜿蜒的；弯曲复杂的；不老实的
substantiate	证实；验证
suborn	教唆
shyster	不择手段的律师
travail	辛苦劳作
supplicate	恳求
traumatic	创伤的
striated	有条纹的
squat	矮壮
trenchant	一针见血；犀利
surfeit	饮食过度；沉溺于
smirk	得意地笑
swindler	骗子
skirmish	战役
studied	有计划的；故意的
satirical	讽刺的
turbulence	湍流；动荡
succumb	屈服；屈从；死
supple	柔软的
servile	奴性的
sphinx-like	神秘的
surmise	猜测
sporadic	零星的
swathe	绑；裹
subdued	柔和的
sparse	稀少的；稀疏的
terse	简洁；扼要的
stint	限量；节约
supersede	取代
subsequent	后来的；接下来的
susceptible	易受影响的
sensual	肉欲的
tautological	同义反复的
suppress	压制
turgid	肿胀；晦涩难懂
tempo	拍子
trigger	引起；触发；扳机
scad	许多，大量
stagnant	停滞的
solicitous	关切的
subordinate	下级的
snivel	啜泣
transition	过渡
tepid	温
testy	易怒的
traduce	诽谤
slag	渣
scenario	情节；剧本
scurry	急跑
scrutinize	明察
spatial	空间的
succulent	多汁的
saboteur	破坏分子
skinflint	守财奴；吝啬鬼
skeptic	怀疑论者
turmoil	骚乱
tremulous	颤栗
saturnine	忧郁的
temerity	鲁莽
salacious	好色
satire	讽刺的
terrestrial	地的；地球的
sultry	闷热；性感
talisman	护身符；避邪物
staccato	断续的
sodden	湿透的；麻木的
swarthy	黝黑的
slither	滑动
tenacious	坚韧不拔
slake	解渴
totter	蹒跚；摇摇欲坠
somnambulist	梦游症患者
scaffold	脚手架
thespian	戏剧的
scurvy	卑鄙
sanctimonious	伪善的
sanguine	乐天的
swelter	热昏中暑
trifling	微不足道的
sear	灼伤
secular	世俗的
succor	援助；救援
serrated	锯齿状的
truism	真实性
subsistence	生计
severity	严肃；严格；严重
subjective	主观的；个人的
staid	一本正经
spectrum	光谱
suture	缝合；缝合处
sophistry	诡辩
spendthrift	败家子
sedition	叛乱
spontaneity	自发的；自然的
shrewd	精明
tantalize	挑逗
shear	剪；修剪
swerve	突然转向
sacrilegious	亵渎的
sardonic	讽刺的
subliminal	低于极限的；下意识的
seismic	地震的
slipshod	马虎草率
submissive	顺从的
stupefy	使恍惚；使茫然
sarcasm	挖苦；讽刺
seedy	破烂
spat	口角 冲突
sordid	肮脏；卑鄙
singular	单数；非凡，异常
strew	散播
sedentary	久坐的；坐惯的
salutary	有用的；有益的
transient	短暂的
shirk	逃避，推卸；避免
tedious	冗长
trepidation	惧怕
supercilious	自大的；傲慢的
stolid	:-|
sanction	批准
table	搁置
substantive	实质的
throes	剧痛
sinecure	闲职
servitude	奴役
tirade	长篇攻击性演说
shackle	束缚
sagacious	有洞察力的
titular	名义上的；有名无实的
sibling	兄弟姐妹
spasmodic	断断续续的；间歇的;痉挛
tractable	易驾驭的
touchstone	标准
seep	渗出；渗漏
timidity	胆怯
timorous	害怕的
sedate	镇静
tract	大片土地；小册子，短文
theoretical	理论的
stipend	薪水
sap	破坏
secrete	藏匿；分泌
tycoon	大亨
salient	显著的；突出的
translucent	半透明的
torrent	急流
thrive	繁荣
soluble	可溶解的；可解决的
tutelage	监护
tout	吹捧
trespass	非法侵入
shimmer	闪烁
stanch	止血
smolder	闷烧；郁积
sojourn	逗留
sever	切断
tenuous	纤细的
sycophant	马屁精
scapegoat	替罪羊
scamp	流氓
scourge	祸根；折磨
symmetry	对称；匀称
sinister	邪恶的
sinewy	多肌腱的，肌肉发达
stifle	窒息，扼杀
stem	花茎，树干；遏制
stipulate	规定
static	静态的
simile	明喻
soliloquy	自言自语；独白
spawn	产卵
subservient	奴性的
subsidy	补助金
treacly	甜蜜；过于伤感
sluggard	懒人
savory	有滋味的
sedulous	勤奋的
statute	法令；条例
shard	陶瓷碎片
satellite	人造卫星
tempestuous	有暴风雨的
tenure	任期；（土地的）使用年限
suavity	温和
sybarite	纵情逸乐之徒
savant	专家，学者
scintillate	迸出火花
sluggish	行动迟缓的
sanctuary	庇护所，圣堂
tarry	逗留
thrifty	节省的；抠包的
steep	陡峭；浸泡
smelt	冶炼
sunder	分裂
slapdash	草率，匆促
tantamount	同等的
scanty	缺乏；不足
taciturn	沉默寡言的
sovereign	有独立主权的；至高的；君主
specious	似是而非的
succinct	简洁的；紧身的
tacit	默许的
superfluous	多余的
treatise	论文
schematic	示意的，图解的
threadbare	褴褛的；破烂不堪的
trek	长途跋涉；旅行
transparent	透明
splice	接合
soporific	催眠的
solecism	语法错误；谬误
sartorial	裁缝的；缝纫的；
sublime	崇高的
sadistic	虐待狂的
sage	圣人
simulate	模仿；冒充
surly	粗暴的
transgression	违反道德准则
tyro	新手
tether	栓
summit	顶点
tendentious	偏见的
sham	佯装
travesty	恶搞
stigma	耻辱，污名
termination	结束
seamy	丑恶的
stymie	阻碍
scavenge	腐食
transport	狂喜
somnolent	昏昏欲睡
tender	提出;温柔；嫩；纤弱
sully	弄脏；玷污
squabble	争吵
scrupulous	小心谨慎
spate	洪水；大量
supposition	假定；假想
saturate	饱和；渗透
Stoic	坚忍
schism	分裂
tiller	舵柄
tonic	滋补的
subpoena	传票
surreptitious	秘密的
shun	避
subside	消退
trappings	装饰
serenity	平静
snicker	窃笑
temperament	气质；性情
taint	污染，感染；污点
superficial	肤浅的
stealth	秘密行动
temperate	节制的；温和的
satiate	完全满足
scoff	嘲弄
tenacity	坚韧不拔
subsidiary	附属品
turncoat	变节者
stoke	加燃料
tortuous	扭曲
seemly	适宜的，合适的
solemnity	严肃的
turbid	浑浊；混乱
transitory	转瞬即逝
tremor	颤栗
solvent	有偿付能力的；溶剂
transmute	使变形
surrogate	代替
saunter	漫步；闲逛
sleight	灵巧
toady	马屁精
scuffle	扭打
sustain	支撑；延续
trite	陈腐的
substantial	大量结实的
slacken	松弛，放慢
sportive	嬉戏的；玩闹的
slight	一点儿；怠慢
stratagem	战略
taut	整洁的；紧张
saccharine	极甜的
tangible	可触摸的；真实的
tranquillity	宁静，平静
somber	忧郁的；昏暗的
squander	浪费
solicit	恳求
tumult	喧嚣
temporize	拖延时间；见风使舵
stellar	星的；主要的
sacrosanct	神圣不可侵犯
serendipity	有发现意外之财的运气
stringent	严厉的
suffragist	女权主义者
theocracy	神权政治
temper	温和的
spurn	唾弃
synoptic	摘要的
titter	神经质的笑
squalor	脏；惨；穷
slur	模糊不清的说；诽谤，中伤
superimpose	叠加
therapeutic	治疗的；治疗学的
toxic	有毒的
slough	脱落；蜕皮
scuttle	急跑